R 1100 700
NO ./textures/facebook.xpm
SO ./textures/blue.xpm
WE ./textures/brick.xpm
EA ./textures/grey.xpm

S ./textures/textures/barrel.xpm
F 128,128,128
C 135,206,235

        1111111111111111111111111
        1000000002110000000000021
111111111000000000000000000011111
10000000000000000000000000001
100000000000000011100001100011
10000000000000001 100000000001
10000000000000001111010000001111 1
11000001110101011100011000W0111
11112111 1112121 121211000001
11111111 1111111 111111111111
